W W W W W W W W
W G G G G G G T
W W G W W G G G
W W W G W G G T
W G G G G G G G
W G G G G G G W
W G G G G G G G
W W G W W W G W
W W G T G G G G
W W G T G G G G
W W G W W W G W
W G G G G G G W