W G G G G G W W
W G G G G G G G
W G G W W G W W
W G G W G G G G
W T G W W G W W
W T G G G G G G
W T G G G G G W
W G G W W W G G
W G G G G G G W
W G G G G G W G
W T G G G G W T
W T T G G G G G