W T T G G G G G
W T G G G G W T
W G G T G G W G
W G G T T G W T
W G G T G G W W
W G G G G G G W
W G G G G G W G
W W W G W W G T
W G G G G G G G
W W W G W W G T
W G G G G G G T
W W W W W W W W