W W W W W W W W
T G T G G G G G
G G G G G G G G
T G T G G G G G
G W W G W W W W
W G T G G G G T
G G T G T T G T
W G G G G G G G
G G T G T T G T
G G T G G G G T
W G G G T T G G
W G T G G G G T