W G T G G G G T
G W W G W G G W
W G T G T G G G
G G G G G G G T
W G T G T G G T
G W T G T G G G
W W W W W G G W
G G G G G G G G
W G G G G G G G
G G G W W G G W
T G G W G G G G
G G G G W W W G