G G G G W W W G
T G G W G G G G
G G G W G G G G
T G W G G G G G
W G G G G G G G
W G W W W G W W
G G G T G G G G
T G G T G G T G
G G G G G G T G
T G G G G G T G
T G G T G G G G
W W W W W W W W