W W W W W W W W
G W G G G T T W
G W G G G G T W
G G G G G G G W
W G G W W G G W
T G G G W G G W
T G T G W G G W
G G T G G G G W
T G T G G G G W
T G T G W G G W
G G T G W G G W
T G G G W G G W