T G G G W G G W
W W W W W G G W
G G W G G G G W
T G G G G G T W
T G G G G T T W
G G W G G G T W
W W W G G G G W
G G W G G G G W
G G G G G G G W
W W W G W G G W
G G G G W G G W
G W W W W G G W