G W W W W G G W
G G G G W G G W
G G G G W G G W
G G G G G G G W
G G G G G G G W
W W G T G T G W
G W G T G T G W
G W G G G G G W
G W G T G T G W
G G G T G T G W
G G G G G G G W
W W W W W W W W