W W W W W W W W
W G G W G T G G
W G G G G G G T
W T G G G T G G
W G G G G G G T
W G G W G T G G
W T G W W W W W
W G G G G G G G
W G G T G G G T
W T G G G T G G
W G G T G G G T
W W W W W W G W