W W W W W W G W
W G G G G G G G
W G T T G T T G
W G T T G T T G
W G G G G G G G
W G T T G T T W
W G T T G T T W
W G G G G G G G
W G T T G T T W
W G T T G T T W
W G G G G G G G
W G T T G T T W