W G T T G T T W
W G G G G W W W
W G T W G G G G
W G T W T T G T
W G G G G G G G
W W W W W G W W
W G G G W G G G
W T T G W T G T
W T T G W T G T
W G G G G G G G
W G G G G G G G
W T T G W T G T