W T T G W T G T
W G G G G G G G
W G G G G G G G
W T T G W T G T
W T T G W G G G
W G G G W W W G
W G G G G G G G
W W W W W W W W
W G G G T G G G
W G T G G G T G
W G G G T G G G
W W W W W W W W