W W W W W W W W
G G T G G G T G
T G G G T G G G
G G T G G G T G
T G G G T G G G
G G T G G G T G
W W W W W W W G
G G G G G G G G
T G G G T G G W
G G T G G G T W
T G G G T G G W
W W W W W W G W