W G T G T G T G
W W W G G G G G
G G W G T G T G
T G W G W W G G
G G G G G W T G
W W W W G W W W
G G G G G G G G
T G T T G T T G
T G T T G T T G
G G G G G G G G
G G G G G G G G
T G T T G T T G