W W W W W W W W
G G G W G G G T
G T G G G T G G
G G G W G G G T
G T G G G T G G
G G G W G G G T
G W W W W W W W
G G G G G G G G
W G T T G T T G
W G T T G T T G
W G G G G G G G
W G T T G T T G