G T T G W G G G
G G G G W G G T
W W W G W G G T
G G G G G G G G
G T T G T T G T
G T T G T T G T
G G G G G G G G
W W W W W W G T
G G G G G G G T
T G T T W G G G
G G G G G G G G
W W W W W W W W