W W W W W W W W
T T W G T T T W
G G G G G G T W
T T W G T G G W
G G G G T G G W
T T W G G G G W
W W W G T G G W
G G G G T G G W
G T W G G G G W
G T W G T G G W
G G G G T G G W
G T W G G G G W