T T W G G T T W
G G G G T G T W
T T W G T G G W
G G G G G G G W
T T W G G G G W
W W W G T G T W
G G G G T T T W
T G G G G T T W
G T W G G G T W
T G G G T G G W
W W W G T G G W
G G W G G G G W