W W W W W G G W
W G G G G G G W
W G G G G G G W
W G G G W G G W
W G G G W G G W
W W G W W G G W
W G G G W G G G
W G G G G G G G
W G G G G G G W
W T G G W G G W
W T T G W G G W
W W W W W W W W
