W W W W W W W W
W T T G G G G G
W T G G G G G G
W G G G G G G G
G G G G G G G G
G G G G G G G G
W G G G G G G G
W G G G G G G G
W G G G G G G G
W G G G G G G G
W T G G G T T W
W W W G G W W W