W W W G G W W W
W G G G G T T W
W G G G G T G W
W G G G G G G W
W G G G G G G W
G G G G G G G G
G G G G G G G G
W G G G G G G W
W T G G G G G W
W T T G G G G W
W T T T G G G W
W W W W W G G W