W W W W W G G T
W G G G G G G T
W G G G G G G T
W G G G G G G T
W G G G G G G T
W G G G G G G T
G G G G G G G G
G G G G G G G G
W G G G G G G W
W G G G G G G W
W G G G G G G W
W W W W W W W W