W W W W W W W W
G W T T G G T W
G W T G G G G W
G G G G G G G W
G G G G G G G W
G W G G G G G W
G W T G G G G W
G W W W W W W W
G G G G G G G W
G G G G G G G W
T G G G G G T W
T G G G G T T W