T G G G G T T W
T G G G G G T W
T G G G G G G W
T G G G G G G W
W W W W W G G W
G G G G W G G W
G G G G W G G W
W W W G W G G W
W G W G W G G W
W G W G W G G W
W G W G W G G W
W G W G W G G W