T G W G W G G W
T G W G W G G W
T G W G W G G W
T G W G W G G W
T G W G W G G W
T G W G W G G W
G G G G G G G W
G G G G G G G W
W W W G W G T W
W G G G W G T W
W G G G W G T W
W W W W W W W W