T W T W T W T W
W G G G G G G G
T G G W W G G W
W G W W W G W W
T G G W W G G W
W G G G G G G G
T G G T T G G T
W G G G G G G G
T G G W W G G W
W G W W W G W W
T G G W W G G W
W G G G G G G G