T G G G G G G G
W G G W W G G W
T G W W W G W W
W G G W W G G W
T G G G G G G G
W G G T T G G T
T G G G G G G G
W G G W W G G W
T G W W W G W W
W G G W W G G W
T G G G G G G G
W G G G G G G G