T W T W T W T W
G G G G G G G G
W G G G G G G G
W G T W W W W T
W G W G G G G W
G G G G G G G W
T G G G G G G W
G G W G G G G W
W G T W W W W W
W G W G G G G W
W G G G G G G W
G G W G G G G W