G G W G G G G W
W G T W W W W T
W G G G G G G G
W G G G G G G G
G G T W W W W T
T G W G G G G W
G G W G G G G W
W G G G G G G W
W G G G G G G W
W G W G G G G W
G G T W W W W T
G G G G G G G G