G G G G G G G G
W W W T G T W W
G G G W G G G G
G G G G G G G G
G G G W G W G G
W W W T G T W W
G G G W G W G G
G G G W G W G G
G G G W G W G G
G G G W G W G G
W W W T G T W W
G G G G G G G G