T W T W T W T W
G G G G G G G G
G G G G G G G G
W W W G W W T G
W G G G G G W G
W G G G G G W G
W G G G G G T G
W G G G G G W G
W W T T W W W G
W G G G G G W G
W G G G G G T G
W G G G G G W G