W G G G G G W G
W W W G W W T G
G G G G G G G G
G G G G G G G G
W W T W W W T G
W G G G G G W G
W G G G G G W G
W G G G G G W G
W G G G G G W G
W G G G G G W G
T W W G G W T G
G G G G G G G G