G G G G G G G G
W W G W T G G W
G G G G W G W W
G G G G W G G W
G G G G W G G G
T W W W T G G T
G G G G G G G G
G G G G G G G W
W T W W W G W W
G G G G G G G W
G G G G G G G G
W T W T W T W T