T W T W T W T W
G G G G G G G T
G G G G G G G W
G T G W W T G T
G W G G G W G W
G W G G G W G T
G W G G G W G W
G T W W W T G T
G W G G G W G W
G W G G G G G T
G W G G G W G W
G T W W W T G T