G T W W W W G W
G W G G G W G T
G G G G G T G W
G W G G G W G T
G T W W W W G W
G W G G G W G T
G W G G G T G W
G W G G G W G T
G W G G G W G W
G W G G G W G T
G T W G W T G W
G G G G G G G T