W W W W W W W W
W G G G G G G G
W G G W G G G G
W G W W G G W T
W G W G G W W T
W G W G T G G G
W G G W G G G G
W G G W W G G G
W G G G G W G G
W G G G G G W G
W G G G G G W G
W T G G G G G W