W G W G W W W G
W G W G G G W G
W G W T G G G G
W G W G T G G G
W W G G G G G T
W W G G G G T G
W W G G G G G G
W W G G G G G G
W W G G G G G T
W W G G G G G G
W W G G G G G T
W W G G G G T G