G W G W G W T T
G G G G W G G G
G G G G G W G G
G G G G G G G G
T G W W G G G W
G W G G W G G G
G W W G G G G T
G G T W G G G T
T G G G W G G G
G G G G G W G G
T G G G G W W W
G W W G W G G G