W W W W W W W W
G G G G G G G G
G G G G G G G G
G G G G G G G G
G G G W W W G G
G G G G G G W G
W G W G G G T W
W W W G G T G G
G G W G G G G T
G G W W T G G G
W G G W W G G G
G G G G W G W W