G G G G W G W W
G G G G G W G G
W G G G G G G G
G G W G G G G G
G G G W G T G G
G G G W G G G T
G T T W G G G G
G T G W G G G G
G G G T W W W G
G G G G G G G W
G G G G G G G G
T G G G G G G G