W W W W W W W W
G G G G T G G W
G G G T T G G W
G G G G T G G W
G G G G G G G W
G G G G G G G W
W G G G G G G W
G W G G G G G W
T G W W G G G W
G G G G W G G W
G G G G G W G W
W W G G W W W W