W W G G W G G G
W W G G W G G T
W W G G G G G T
W G W G G G G W
W G W G G G G G
W G G G G G G G
W W G G W W W W
W G G G G G G G
W T T W G G G W
W G T T G G G G
W G T G G G G G
W G G G G G G G