W W W W W W W W
G G G G G G G G
W G W W W W G G
G G G G G G G G
W W W G G W W W
G G G G G G G G
G G G G G G G G
W W W G G G G W
G G G G G W G G
T G W G W G G G
T G G W W G G T
G G G W W G G T