G G G W W G G T
T G G G W G G T
T G W G G W G G
W W W G G G G G
G G G G G G G W
G G G G G G G G
W W W G G W W W
G G G G G G G G
W G W W W W G G
G G G G G G G G
G G G G G G G T
G W W G G G G T