G W W G G G G T
W G G G G G G G
T G G W W G G G
T G G W W G G G
G G W G G G G W
G W G G G G G G
G G G G W G G G
G G G W G G G G
G G W W G G G W
G G G G G W G G
W W W G W G G W
W W W W W W W W