T T G G W G W W
T G G G W G W W
G G G G W G W W
G G G G G G G W
W G G G G G G W
G G G G W G G W
W G G W G G G W
G G W G G G G W
G W G T G G G W
G G G G T G G W
T G G T G G G W
T G G G G G G W