W G G G W G W G
W W W G W G W G
W G W G W G W G
W G W G W G W W
W G W G W G G G
W G W G W G G G
W G W G W G W W
W G W G W G W G
W G W G W G W G
W G W G W G W W
W G W G W G W G
W G G G W G W G