G W G W G G G G
G W G W W W W G
G W G W G G G G
G W G W G G G G
G W G W W W W W
G W G G G G G G
G W G G G G G G
W W W W W W W W
G G G W G G G G
G G G W G G G G
G G G W G G G G
W W W W W W W W